121.5 MHz Homing	boolean
Activation Type	string
Additional Data Flag	string
Additional ELT numbers	integer
Aircraft 24 bit address Binary	string
Aircraft 24 bit address (hex)	string
Aircraft 24 bit address (octal)	string
Aircraft CallSign	string
Aircraft Operator	string
Aircraft Reg. Marking	string
Aircraft Serial Number	integer
Aux. radio-locating	string
BCH-2	string
Beacon Serial Number	integer
Beacon Type	string
Coarse Position Latitude	number
Coarse Position Longitude	number
Country Code	integer
Country of Registration	string
C/S cert. no. present	boolean
C/S Type approval	integer
C/S Type approval number	integer
Disabled	boolean
Emergency Code Flag	string
Emergency Code	string
Encoded Position Source	string
Error Correcting Code	string
Fine Position Latitude	number
Fine Position Longitude	number
Fire Flag	boolean
Fixed bits	string
Hex Data	string
Hex Id	string
ID+POSN	string
Is Long Message Default	boolean
Latitude	number
Longitude	number
Medical Help Flag	boolean
Message Type	string
National Use	string
Nature of Distress	string
Offset Position Latitude Diff	number
Offset Position Longitude Diff	number
Orbitography 4 bits	string
Orbitography Data	string
Orbitography ID	string
PDF-2	string
Protocol Type	string
Radio Callsign	string
RLM Capability Type-1 (Auto)	boolean
RLM Capability Type-2 (Manual)	boolean
RLM Capability Type	string
RLM Received Type-1 (Auto)	boolean
RLM Received Type-2 (Manual)	boolean
RLS ID	integer
RLS Provider ID	string
RLS TAC Number	string
Serial Number	integer
Ship MMSI	integer
Ship Security MMSI	integer
Ship MMSI Last 6 Digits	string
Spare	string
Specific Beacon Number	string
Specific ELT number	integer
Supplementary Data	string
User Protocol Type	string
US Manufacturer ID	integer
US Model ID	integer
US National Use	string
US Run No.	integer
US Sequence No.	integer